%%%%%%%%%%%%%%
%          ..%
%  %%%  %%%% %
%  G %   %  .%
%%%%%%%.  %%%%
%G %      % G%
%           %%
%..         P%
%%%%%%%%%%%%%%
% % % %%%%%%%%
%%%%%%%%%%%%%%