%%%%%%%%%%%%%%%%%%%%
%G                 %
% %     %%%%%%%%%%%%
%%%%       ..     G%
%  %   .  %%%%%   %%
%         %G.      %
%%%       %%%%%%%  %
%P                 %
%%%%%%%%%%%%%%%%%%%%
% % % %%%%%%%%%%%%%%
%%%%%%%%%%%%%%%%%%%%
