%%%%%%%%%%%%%%
%         G..%
%  %%%  %%%% %
%  %    %  . %
%  %  %.  %%%%
%    G%   % G%
%%%%%%%     %%
%..         P%
%%%%%%%%%%%%%%
% % % %%%%%%%%
%%%%%%%%%%%%%%
