%%%%%%%%%%%%%%
%   .       G%
%.%%%%% %%%% %
% %%       % %
% %%   .   % %
% %%       %.%
% %%       % %
%.G%  P    %G%
%%%%%%%%%%%%%%
% % % %%%%%%%%
%%%%%%%%%%%%%%
