%%%%%%%%%%%%%%
%           G%
%P %    %%%%%%
%%%%       ..%
%G %   .  %%%%
%         %..%
%%%       %  %
%..         G%
%%%%%%%%%%%%%%
% % % %%%%%%%%
%%%%%%%%%%%%%%
