%%%%%%%%%%%%%%
% G%G       G%
%  %%%  %%%%%%
% %%         %
% %% %%% %%%%%
%          ..%
% %%%%%%%%%  %
%....       P%
%%%%%%%%%%%%%%
% % % %%%%%%%%
%%%%%%%%%%%%%%
