%%%%%%%%%%%%%%%%%%%%%%%%%%%%  
%   .        %%% G  %   %  %
%.%%%%% %%%% %%     %% %% %%
% %%       % %% %%%%%% %% %%
%.%%       % %             %
%.%.       %.%    %%%%%%%% %
%.%%       % %%   %.. G..  %
%.G%  P    %     %%%%%%%%% %
%%%%%%%%%%%%%%%%%%%%%%%%%%%%
% % % %%%%%%%%%%%%%%%%%%%%%%
%%%%%%%%%%%%%%%%%%%%%%%%%%%%
