%%%%%%%%%%%%%%
%P           %
%%%%%%       %
%..       %%%%
%%%%        G%
%G           %
%%%%         %
%           G%
%%%%%%%%%%%%%%
% % % %%%%%%%%
%%%%%%%%%%%%%%
