%%%%%%%%%%%%%%
%%%%.G % %  G%
%G %%%  %%%% %
% %% % %     %
% %%   .  %%%%
%         %..%
%%%       %  %
%....       P%
%%%%%%%%%%%%%%
% % % %%%%%%%%
%%%%%%%%%%%%%%
