%%%%%%%%%%%%%%
%%%%.P % %  G%
%. %%%  %%%% %
% %% % %     %
% %%   .  %% %
%   .     %..%
% %%%     %% %
%.G%%     % G%
%%%%%%%%%%%%%%
% % % %%%%%%%%
%%%%%%%%%%%%%%
