%%%%%%%%%%%%%%%%%%%%
%G %               %
%  %    %%%%%%%%%%%%
%  %      ..      P%
%  %   .  %%%%%%   %
%           . G%   %
%%%       %%%%%%   %
%              %G  %
%%%%%%%%%%%%%%%%%%%%
% % % %%%%%%%%%%%%%%
%%%%%%%%%%%%%%%%%%%%
