%%%%%%%%%%%%%%
%G           %
%            %
%            %
%     P      %
%            %
%            %
%           G%
%%%%%%%%%%%%%%
% % %%%%%%%%%%
%%%%%%%%%%%%%%
