%%%%%%%%%%%%%%
%P           %
%%%%%%%%     %
%            %
%G           %
%    G       %
%            %
%           G%
%%%%%%%%%%%%%%
% % % %%%%%%%%
%%%%%%%%%%%%%%
