%%%%%%%%%%%%%%
%   .     % G%
%.%%%%%%  %% %
%   %        %
% %%%  .  %% %
%   %     %..%
% %%%     % %%
%.G%% P   % G%
%%%%%%%%%%%%%%
% % % %%%%%%%%
%%%%%%%%%%%%%%
