%%%%%%%%%%%%%%%%%%%%%%%%%%
% G%     %              P%
%  %    %%  %%%%%%%%%%%%%%
%% %    %%   ..          %
%  %   .%%  %%%%%%%%%%%%%%
%   %%      %G.          %
%%%  %     %%%%%%%%%%%%  %
%..         ..G       %  %
%%%%%%%%%  %%%%%%%%%%%%  %
%.                       %
%%%%%%%%%%%%%%%%%%%%%%%%%%
% % % %%%%%%%%%%%%%%%%%%%%
%%%%%%%%%%%%%%%%%%%%%%%%%%
