%%%%%%%%%%%%%%%%%%%%%%%%%%%
%   P            %        %
% %%%%%%%%%%%%%%%%% %%%%% %
%                       % %
%%%%%%%%%%%%%%%%%%%%%%%%% %
%                         %
% %%%%%%%%%%%%%%%%%%%%%%%%%
%             %%%%     G%%%
%%  %%%%%%%%%%%%%%%%%   %%%
%                         %
%%%%%%%%%%%%%%%%%%%%%%%%%%%