%%%%%%%%%%%%%%%%%%%%%%%%%%%
%   P            %        %
% %%%%%%%%%%%%%%%%% %%%%% %
%                       % %
%%% %%%%%%%%% %%%%%%%%%%% %
%                 G G     %
%%%%%%%%%%%%%%%%%%%%% %%%%%
%             %%%%   GG%%%%
%%%%%%%%%%%%%%%%%%%%%%%%%%%
%%%%%%%%%%%%%%%%%%%%%%%%%%%
% % % % %%%%%%%%%%%%%%%%%%%
%%%%%%%%%%%%%%%%%%%%%%%%%%%